row,columnList,,,,,,,,,,,,,,
row,c1,c2,c3,c4,c5,c6,c7,c8,c9,c10,c11,c12,c13,c14,c15
6,1,0,0,0,0,0,0,0,0,0,0,0,0,0,1
5,1,0,0,0,0,0,0,0,0,0,0,0,0,0,1
4,1,0,0,0,0,0,0,0,0,0,0,0,0,0,1
3,1,1,1,1,1,0,0,0,0,0,0,0,1,1,1
2,1,1,0,0,0,0,0,0,0,0,0,0,0,1,1
1,1,1,0,0,0,0,0,0,0,0,0,0,0,1,1
0,1,1,0,0,0,0,0,0,0,0,0,0,0,1,1
-1,1,1,0,0,0,0,0,0,0,0,0,0,0,1,1
-2,1,1,0,0,0,1,1,1,1,1,1,1,0,1,1
-3,1,1,0,0,0,0,0,0,0,0,0,0,0,1,1
-4,1,1,1,1,1,1,1,1,1,1,1,1,1,1,1
-5,1,1,1,1,1,1,1,1,1,1,1,1,1,1,1
